1 13 31
###############################
#p     ** *  1 *   *  * * *   #
# # # #*# # #*#*# # # #*#*#*# #
#  f*     ***  *      *   * * #
# # # # # #*# # #*#*# # # # #*#
#b         x **  *  *         #
# # # # # # # # # #*# #*# # # #
#*  * s    *  *      *  1     #
# # # # #*# # # #*#*# # # # # #
#*    **  *       *    2      #
# #*# # # # # # #*# # # # # # #
#    1      *   *  *          #
###############################