1 13 31
###############################
#p     ** *  1 * 2 *  * * *   #
# # # #*# # #*#*# # # #*#*#*# #
#  f*     ***  *  1   * 2 * * #
# # # # # #*# # #*#*# # # # #*#
#b         x **  *  *   1     #
# # # # # # # # # #*# #*# # # #
#*  * s    *  *      *        #
# # # # #*# # # #*#*# # # # # #
#*    **  *       *           #
# #*# # # # # # #*# # # # # # #
#   1       *   *  *          #
###############################