1 13 31
###############################
#p     ** *  1 *   *  * * *   #
# # # #*# # #*#*# # # #*#*#*# #
#  f*     ***  *  1   *   * * #
# # # # # #*# # #*#*# # # # #*#
#b         x **  *  *  2      #
# # # # # # # # # #*# #*# # # #
#*  * s    *  *      *        #
# # # # #*# # # #*#*# # # # # #
#*    **  *       *    1      #
# #*# # # # # # #*# # # # # # #
#           *   *  *          #
###############################