1 13 31
###############################
#p     ** *  1 *   *  * * *   #
# # # #*# # #*#*# # # #*#*#*# #
#  f*     ***  *      *   * * #
# # # # # #*# # #*#*# # # # #*#
#b         x **  *  *  2      #
# # # # # # # # # #*# #*# # # #
#*  * s    *  *      *        #
# # # # #*# # # #*#*# # # # # #
#*    **  *       *     1     #
# #*# # # # # # #*# # # # # # #
#      2    *   *  *          #
###############################